11111111111111111111111111111111111
1.................................1
1.................................1
1...P......1111111111.......M.....1
1..........1........1.............1
1..........1........1.............1
111111111111........1.............1
....................1.............1
....................1.......M.....1
....................11............1
.....................1............1
.....................11111111111111
